Name,Volume,Ask Size,Ask Price,Bid Size,Bid Price,Last Price,Shares Matched,Shares Routed
UVXY,13546733,155,13.55,18,13.47,13.49,13466965,79768
VXX,11029513,100,20.04,300,19.90,19.98,10885149,144364
VIXY,2395586,82,16.40,34,16.32,16.38,2375646,19940
IEFA,1521996,20,71.51,1,68.60,69.52,1491390,30606
ARKG,1337256,1,104.78,100,104.72,104.70,1313361,23895
GOVT,728434,1,28.00,3,27.08,27.12,724084,4350
SVXY,722302,346,36.96,322,36.88,36.82,708609,13693
RSX,675351,100,23.89,12,23.71,23.89,615521,59830
INDA,652701,20,40.78,200,40.53,40.72,651466,1235
USMV,635124,151,70.00,1,65.75,66.70,619343,15781
ARKQ,514067,145,91.50,1,91.20,91.17,512355,1712
SLVP,502975,1,18.51,1,18.00,18.01,476188,26787
ITB,498258,200,62.00,2,58.02,59.97,489855,8403
EZU,463319,0,0.00,1,38.44,43.85,459367,3952
MTUM,346310,50,168.59,30,165.49,167.90,345929,381
EFV,327720,10,49.50,1,47.00,47.43,322922,4798
CBOE,240059,70,96.00,100,92.47,95.00,239100,959
IDV,225283,5,32.00,1,29.50,29.87,224742,541
IGV,210509,10,360.00,10,344.00,357.54,209901,608
REM,210020,11,33.30,4,30.88,31.65,198746,11274
FLOT,187237,500,50.84,15,50.82,50.82,177068,10169
JPST,169241,1500,50.79,3433,50.77,50.78,169241,0
OGIG,167780,3,58.88,20,57.97,58.27,167680,100
EFAV,150677,1,74.70,5,69.00,73.00,148301,2376
USHY,147208,0,0.00,2,41.00,41.08,145925,1283
VLUE,124363,5,92.50,80,65.46,90.91,124061,302
QUAL,117986,3,125.00,20,113.50,114.46,115711,2275
BBJP,116040,0,0.00,150,23.69,28.02,114970,1070
EFG,108276,0,0.00,1,99.50,101.20,89242,19034
BBCA,104096,0,0.00,5,24.00,26.89,101305,2791
HYD,101179,300,63.00,175,62.57,62.62,97035,4144
PFEB,98521,0,0.00,0,0.00,26.65,98521,0
BBAX,97840,0,0.00,0,0.00,27.64,91365,6475
BBEU,91599,0,0.00,0,0.00,26.20,76204,15395
NEAR,90227,2000,50.22,500,50.19,50.21,89827,400
HEFA,89284,100,33.99,0,0.00,30.95,85410,3874
PAVE,88450,40,21.37,5,21.10,21.27,88226,224
TAIL,82166,5,23.00,5,20.30,20.40,81766,400
VNM,75896,50,19.00,100,17.01,17.05,75691,205
ECH,72763,8,41.71,4,29.52,30.52,71657,1106
ESGV,72275,2,78.00,5,70.00,71.09,72272,3
PRNT,68936,10,41.76,1,41.30,41.76,68650,286
NOBL,67549,10,80.27,3,78.30,78.80,66598,951
ICSH,60057,3841,50.53,2000,50.50,50.52,59908,149
ITA,54100,100,91.50,1,90.45,90.61,53545,555
ACWV,53366,2,99.00,2,93.00,96.28,52554,812
IGE,42360,205,25.68,1,23.65,23.89,42360,0
VSGX,42221,20,62.01,100,58.01,60.65,42221,0
XJR,40291,0,0.00,0,0.00,35.64,40291,0
EEMV,38285,0,0.00,2,61.00,62.54,38268,17
DUDE,37441,0,0.00,0,0.00,27.95,30541,6900
MOAT,36458,0,0.00,15,59.50,62.25,36297,161
BFEB,33494,0,0.00,0,0.00,27.85,33494,0
IYLD,31896,1,24.05,1,23.75,23.78,31796,100
IEO,31294,964,41.50,100,35.00,38.05,30774,520
ICVT,31177,5,102.80,50,100.10,102.08,30676,501
JMST,28715,0,0.00,1,49.98,51.06,28375,340
IYT,27481,700,219.90,1,212.80,216.11,27371,110
ICF,26456,0,0.00,15,52.50,54.76,26313,143
UFEB,26324,0,0.00,0,0.00,26.36,26324,0
IYZ,25830,0,0.00,100,30.85,31.06,25529,301
PICK,25525,25,55.00,10,36.60,37.59,25525,0
FJAN,25361,0,0.00,0,0.00,30.06,25361,0
FBCG,25242,100,30.95,150,27.45,29.68,25242,0
ACES,23041,1,94.50,1,93.83,94.40,23007,34
IZRL,22620,2,33.20,10,32.80,32.87,22402,218
DRSK,22312,172,29.50,0,0.00,29.41,22312,0
VIXM,21608,100,43.42,200,41.50,42.18,20908,700
EMHY,20832,100,46.00,0,0.00,45.83,20832,0
IFRA,19258,5,33.60,34,29.51,30.25,19058,200
JPIB,18415,0,0.00,0,0.00,51.76,18342,73
KNG,18291,0,0.00,0,0.00,47.08,12291,6000
PTLC,18252,11,34.00,5,32.00,32.88,18252,0
XSHQ,16365,0,0.00,3,31.15,34.81,16365,0
PAWZ,15193,39,77.00,2,73.00,73.18,13253,1940
PJAN,14966,0,0.00,0,0.00,30.49,14966,0
FDEC,14475,0,0.00,0,0.00,30.60,14475,0
PTMC,14295,0,0.00,0,0.00,33.17,14295,0
SMMV,13767,5,38.00,5,34.00,35.18,13767,0
CNYA,13194,0,0.00,6,44.18,44.62,12092,1102
MFMS,12967,10,42.14,50,34.85,40.34,12033,934
GSST,12945,0,0.00,0,0.00,50.83,12945,0
QDEC,12774,0,0.00,0,0.00,20.26,12715,59
OUSA,12647,3900,38.37,5,37.51,37.64,12646,1
TMAT,12336,0,0.00,2,25.00,25.11,12336,0
TMFC,11928,100,36.00,4300,35.14,35.87,11927,1
BBRE,11479,0,0.00,2,78.00,80.84,11479,0
SMB,11235,1,30.00,120,18.15,18.18,11235,0
SYLD,10331,2,52.05,0,0.00,51.64,10331,0
NULV,10312,0,0.00,0,0.00,32.73,10212,100
EPRF,9797,0,0.00,5,24.09,24.15,9797,0
AFIF,9629,0,0.00,0,0.00,9.73,9629,0
WUGI,9540,100,56.30,9,55.00,55.63,9540,0
SMDV,9459,0,0.00,7,56.03,58.33,9459,0
FDG,9243,5,80.00,5,72.00,75.79,9243,0
UJAN,9075,0,0.00,0,0.00,29.83,9075,0
IYJ,8904,6,102.00,10,92.95,94.72,8904,0
BOCT,8058,0,0.00,0,0.00,30.08,8058,0
VXZ,8024,500,37.00,1,32.69,34.94,7810,214
DALT,7740,0,0.00,0,0.00,10.06,7740,0
SMIN,7552,138,45.48,3,43.36,43.65,7552,0
IBHB,7420,0,0.00,0,0.00,24.20,7420,0
ESML,7221,0,0.00,0,0.00,36.23,7221,0
TSJA,7100,0,0.00,4,25.00,25.67,7100,0
CALF,6918,0,0.00,650,33.00,35.08,6691,227
AGT,6857,0,0.00,1,21.13,25.71,5857,1000
KJAN,6732,0,0.00,0,0.00,29.61,6732,0
OSCV,6684,0,0.00,0,0.00,28.81,6684,0
ACIO,6561,9,28.87,0,0.00,27.32,6361,200
FLV,6533,3,58.00,3,53.00,53.64,6533,0
HYDB,6446,100,60.00,0,0.00,51.20,6446,0
BUFF,6394,0,0.00,0,0.00,33.24,6394,0
RYLD,6282,900,23.01,5,22.65,22.92,6282,0
SVAL,6167,0,0.00,6,25.00,25.76,6167,0
NUSC,6131,6,45.00,25,39.45,40.96,6131,0
XVV,6092,0,0.00,10,28.67,28.94,5592,500
ITM,6021,0,0.00,100,37.66,52.18,5286,735
MEAR,5833,0,0.00,0,0.00,50.28,5833,0
QVAL,5785,0,0.00,2,28.50,29.91,5785,0
EDEN,5752,0,0.00,1,92.31,95.65,5752,0
IAGG,5692,19,56.00,0,0.00,55.89,5692,0
EWUS,5591,0,0.00,1,40.70,42.49,5591,0
BOB,5581,0,0.00,0,0.00,24.35,5581,0
IQDG,5248,0,0.00,0,0.00,37.00,5248,0
DURA,5155,0,0.00,1,27.50,28.01,5155,0
SHYD,5138,10,26.60,0,0.00,25.16,4937,201
CEMB,5043,0,0.00,3,52.77,52.87,5043,0
DFEB,4792,200,35.01,0,0.00,32.56,4792,0
HYXU,4749,0,0.00,0,0.00,55.93,4749,0
FMIL,4694,0,0.00,0,0.00,24.45,4694,0
IGRO,4675,0,0.00,1000,62.71,62.76,4675,0
NULG,4508,6,59.00,3,55.00,57.62,4508,0
XMPT,4500,10000,246.00,35,26.03,28.69,4500,0
SMMD,4423,80,60.00,0,0.00,59.49,4423,0
GSEW,4422,0,0.00,100,53.09,58.03,3822,600
FLDR,4331,157,51.13,0,0.00,51.01,4331,0
PTNQ,4314,9,55.00,3,49.00,52.69,4314,0
BBIN,4255,0,0.00,0,0.00,55.45,959,3296
FBCV,4164,0,0.00,5,23.00,24.18,3441,723
DTEC,4143,7,49.00,53,45.00,47.72,4143,0
BJAN,4064,0,0.00,0,0.00,32.66,2664,1400
USEP,4040,0,0.00,0,0.00,27.00,4040,0
XVZ,4027,0,0.00,10,37.94,39.07,3699,328
TRTY,4020,0,0.00,0,0.00,25.25,4020,0
NUMG,3999,0,0.00,8,46.95,49.70,3999,0
GOVZ,3966,0,0.00,0,0.00,22.40,3966,0
EMGF,3919,0,0.00,0,0.00,51.90,3919,0
VCEB,3746,0,0.00,0,0.00,75.11,3746,0
GTIP,3718,12,61.07,200,57.25,57.53,3718,0
OILK,3640,1,48.68,500,46.60,47.48,3640,0
OUSM,3612,70,49.00,50,28.74,31.24,3612,0
DDWM,3596,85,32.00,0,0.00,28.27,3596,0
EFAD,3536,0,0.00,0,0.00,43.34,3536,0
ENOR,3486,0,0.00,0,0.00,25.39,3486,0
FAUG,3453,0,0.00,0,0.00,34.54,3453,0
IVAL,3268,0,0.00,0,0.00,27.65,3268,0
MAGA,3264,20,32.82,5,28.90,29.77,3264,0
IGHG,3262,0,0.00,0,0.00,75.24,3209,53
TOKE,3223,368,19.10,1005,17.00,18.14,3223,0
SFHY,3198,0,0.00,0,0.00,49.19,3198,0
PSMM,3191,0,0.00,0,0.00,14.69,3191,0
VFQY,3131,0,0.00,0,0.00,103.54,3031,100
WLDR,3121,0,0.00,0,0.00,23.76,3121,0
GVAL,3054,0,0.00,6,20.80,21.19,3054,0
IBMM,3030,0,0.00,0,0.00,27.14,3030,0
HSRT,3026,0,0.00,0,0.00,41.19,2526,500
IBMO,2869,0,0.00,0,0.00,27.17,2769,100
VFMF,2850,0,0.00,0,0.00,87.48,2700,150
FRDM,2826,0,0.00,32,31.26,33.28,2826,0
MLN,2796,0,0.00,26,21.63,21.85,2796,0
IETC,2774,0,0.00,20,46.50,48.53,2709,65
REGL,2722,2,70.00,170,58.66,63.45,2722,0
BDEC,2716,0,0.00,0,0.00,30.36,2716,0
TSOC,2677,0,0.00,50,27.18,28.00,777,1900
PTEU,2656,0,0.00,0,0.00,21.96,2656,0
BBUS,2648,2,75.00,1,60.00,69.36,2348,300
RSXJ,2620,0,0.00,20,35.00,35.76,2620,0
OMFL,2588,3,46.00,0,0.00,41.24,2588,0
PJUL,2549,0,0.00,0,0.00,28.69,2549,0
COWZ,2547,405,38.00,5,34.00,35.27,2547,0
CEFS,2469,0,0.00,155,18.96,19.93,2469,0
IPFF,2469,1,17.77,10,9.80,15.69,2469,0
NUMV,2445,0,0.00,0,0.00,30.91,2445,0
HEEM,2392,0,0.00,50,30.00,32.89,2224,168
EFNL,2380,0,0.00,200,44.50,46.18,2380,0
QMOM,2263,0,0.00,20,56.80,59.29,2263,0
BUFR,2196,0,0.00,0,0.00,21.41,2196,0
CBTG,2161,0,0.00,4,28.01,28.49,2161,0
IBHC,2128,0,0.00,0,0.00,24.39,1772,356
FLQL,2113,9,40.00,10,36.75,37.60,2113,0
DDLS,2103,0,0.00,1,31.15,31.23,2103,0
PSEP,1994,0,0.00,0,0.00,27.84,1994,0
TDV,1949,3,58.00,250,47.03,53.46,1700,249
FLHY,1873,0,0.00,0,0.00,26.33,1873,0
IBHA,1842,0,0.00,25,23.84,24.21,545,1297
WFIG,1801,0,0.00,0,0.00,54.88,1801,0
IGEB,1707,0,0.00,5,54.32,54.60,1707,0
BSEP,1694,0,0.00,0,0.00,29.06,694,1000
GVI,1628,25,117.50,0,0.00,117.14,1628,0
IMOM,1615,0,0.00,0,0.00,35.38,1615,0
GCOW,1607,0,0.00,50,26.75,29.01,1607,0
BUYZ,1604,20,55.00,1,42.22,54.72,1604,0
EUCG,1600,0,0.00,100,23.70,26.10,1600,0
IEME,1502,0,0.00,0,0.00,35.35,1502,0
DJAN,1478,0,0.00,0,0.00,30.03,1478,0
FFTI,1454,0,0.00,0,0.00,24.27,1454,0
NJAN,1441,0,0.00,0,0.00,38.30,1441,0
PBSM,1441,0,0.00,0,0.00,35.50,1441,0
GOAT,1418,0,0.00,0,0.00,35.38,218,1200
DAUG,1403,0,0.00,0,0.00,33.05,1403,0
IEIH,1377,28,34.00,3,33.00,33.90,1377,0
KNGS,1361,0,0.00,10,26.00,27.10,1361,0
FDEM,1333,0,0.00,0,0.00,28.11,1333,0
BMAR,1320,0,0.00,0,0.00,29.89,1320,0
PNOV,1300,0,0.00,0,0.00,28.88,1300,0
PSMB,1269,0,0.00,0,0.00,15.46,1269,0
LKOR,1210,0,0.00,2,60.85,61.21,1210,0
LVHI,1179,1,40.00,20,23.00,23.50,1179,0
IBHD,1144,0,0.00,0,0.00,24.35,1144,0
FMAY,1085,0,0.00,0,0.00,34.52,1085,0
IBMP,1075,0,0.00,0,0.00,27.39,1075,0
PAUG,1033,0,0.00,0,0.00,28.15,1033,0
IAUF,1022,135,57.79,98,56.32,57.45,1022,0
GHYG,1013,0,0.00,0,0.00,50.41,923,90
PMAR,1013,0,0.00,0,0.00,28.50,1013,0
TFIV,1011,0,0.00,100,23.50,23.74,1011,0
FEBZ,1000,0,0.00,0,0.00,25.02,1000,0
PJUN,1000,0,0.00,0,0.00,30.00,1000,0
VFVA,988,0,0.00,0,0.00,81.70,988,0
DFNV,970,0,0.00,0,0.00,26.86,970,0
FFEB,959,0,0.00,0,0.00,33.28,959,0
IEDI,946,0,0.00,2,39.86,40.00,945,1
PEX,945,0,0.00,0,0.00,32.18,945,0
FCPI,895,0,0.00,0,0.00,26.15,895,0
GAA,849,0,0.00,10,26.81,29.96,849,0
JPHY,848,0,0.00,0,0.00,51.83,752,96
VFMO,796,1,132.00,100,43.81,122.48,796,0
PDEC,794,0,0.00,0,0.00,28.86,794,0
ADME,789,4,4294.66,0,0.00,35.86,789,0
EYLD,789,0,0.00,0,0.00,34.56,789,0
HELX,781,0,0.00,150,46.00,49.01,781,0
SECT,751,0,0.00,0,0.00,36.23,389,362
PBUS,738,0,0.00,26,38.17,38.65,738,0
SHAG,701,0,0.00,0,0.00,51.38,606,95
LQDI,696,24,30.98,25,28.83,29.14,96,600
GMOM,676,0,0.00,200,24.42,26.66,676,0
DFND,673,0,0.00,1,35.75,36.32,373,300
BBSA,661,0,0.00,0,0.00,26.10,661,0
NUDM,650,0,0.00,0,0.00,29.42,650,0
FFHG,648,0,0.00,5,30.00,30.74,648,0
UMAR,634,0,0.00,0,0.00,27.73,634,0
FLIA,620,0,0.00,0,0.00,25.42,620,0
TILT,616,0,0.00,0,0.00,147.17,616,0
UOCT,611,0,0.00,0,0.00,26.75,611,0
NUEM,608,0,0.00,0,0.00,35.83,508,100
MSTB,607,3,35.00,100,26.30,27.61,607,0
DEFA,599,0,0.00,0,0.00,30.34,599,0
EWGS,580,0,0.00,1,70.00,78.39,480,100
IBMQ,571,0,0.00,0,0.00,27.67,571,0
PSMC,571,0,0.00,0,0.00,13.49,571,0
BAPR,566,0,0.00,0,0.00,29.68,566,0
JCPB,565,0,0.00,0,0.00,55.40,565,0
BJUL,551,0,0.00,0,0.00,29.99,551,0
DFHY,549,0,0.00,0,0.00,25.15,549,0
CSM,533,0,0.00,0,0.00,86.77,533,0
IECS,520,3,35.00,3,29.00,29.74,520,0
IVLC,508,0,0.00,0,0.00,11.98,508,0
GSUS,503,0,0.00,0,0.00,52.80,503,0
BGLD,501,0,0.00,0,0.00,19.97,501,0
TFJL,501,0,0.00,0,0.00,24.06,501,0
FCTR,500,0,0.00,0,0.00,29.67,500,0
FFTG,500,0,0.00,0,0.00,28.74,500,0
MRSK,485,0,0.00,0,0.00,28.07,485,0
MOTI,475,0,0.00,0,0.00,33.59,475,0
ALFA,468,8,86.00,4,76.00,80.82,432,36
FUNL,465,0,0.00,0,0.00,28.66,465,0
MBBB,441,0,0.00,0,0.00,25.11,441,0
TTAC,423,0,0.00,0,0.00,46.43,423,0
UDEC,419,0,0.00,0,0.00,28.48,419,0
VFLQ,402,0,0.00,0,0.00,95.73,402,0
ATMP,401,0,0.00,0,0.00,12.34,401,0
DJUL,400,0,0.00,0,0.00,31.60,400,0
POCT,397,774,29.11,0,0.00,27.75,397,0
TCTL,396,0,0.00,0,0.00,30.03,396,0
IBHE,386,0,0.00,0,0.00,24.75,386,0
THY,380,0,0.00,0,0.00,25.34,380,0
VFMV,377,0,0.00,0,0.00,90.31,377,0
ESGG,374,1,135.00,0,0.00,125.55,374,0
WFHY,365,0,0.00,1,39.20,52.11,365,0
XJH,359,0,0.00,0,0.00,32.35,9,350
IBHF,354,0,0.00,0,0.00,25.27,354,0
DIVB,346,5,36.00,10,27.81,33.26,346,0
IEHS,344,0,0.00,0,0.00,38.26,344,0
EAOA,341,0,0.00,2,30.50,30.75,341,0
IBMN,318,0,0.00,0,0.00,28.20,318,0
XSHD,317,20,24.58,1,20.31,20.45,317,0
UMAY,306,0,0.00,0,0.00,27.26,306,0
FSEP,303,0,0.00,0,0.00,32.11,303,0
EMDV,302,0,0.00,14,56.34,58.83,302,0
EMTL,301,0,0.00,5,49.87,51.06,301,0
UJUN,300,0,0.00,0,0.00,27.93,300,0
OMFS,293,0,0.00,0,0.00,36.50,293,0
DDEC,286,0,0.00,0,0.00,30.37,286,0
FDEV,267,0,0.00,0,0.00,27.50,267,0
FJUN,259,0,0.00,0,0.00,33.82,259,0
ESG,254,0,0.00,100,88.19,91.64,248,6
DBOC,252,0,0.00,50,26.28,27.10,252,0
IVDG,251,100,13.42,200,11.00,12.05,251,0
HYHG,246,0,0.00,0,0.00,62.04,246,0
VAMO,242,0,0.00,0,0.00,21.50,242,0
LUXE,231,0,0.00,0,0.00,26.81,231,0
NULC,215,0,0.00,0,0.00,35.52,215,0
IVRA,214,0,0.00,100,11.76,11.73,214,0
PMAY,214,0,0.00,0,0.00,28.38,214,0
REC,202,0,0.00,0,0.00,25.31,202,0
PSFD,200,0,0.00,0,0.00,20.63,200,0
PSFF,200,0,0.00,0,0.00,20.46,200,0
FNOV,194,0,0.00,0,0.00,35.03,194,0
NOCT,182,300,42.00,0,0.00,36.19,182,0
BLDG,162,0,0.00,0,0.00,29.20,162,0
UAUG,158,0,0.00,0,0.00,27.78,158,0
FIBR,153,0,0.00,0,0.00,102.09,153,0
OEUR,153,10,26.00,100,24.35,24.78,153,0
LSLT,152,0,0.00,0,0.00,28.03,152,0
IBML,143,0,0.00,0,0.00,26.20,143,0
STOT,139,0,0.00,0,0.00,50.01,139,0
BNOV,129,0,0.00,0,0.00,29.65,129,0
RESE,120,0,0.00,100,30.84,37.61,120,0
ROMO,113,0,0.00,0,0.00,25.30,113,0
XDAT,110,0,0.00,8,24.32,25.54,110,0
EAOK,106,0,0.00,0,0.00,27.15,106,0
PBEE,106,0,0.00,0,0.00,30.21,106,0
JMUB,103,0,0.00,0,0.00,55.36,103,0
FLBL,101,0,0.00,0,0.00,25.00,101,0
DJUN,100,0,0.00,0,0.00,32.29,100,0
NJUL,100,0,0.00,0,0.00,44.58,100,0
PSMG,100,0,0.00,0,0.00,16.44,100,0
USMF,100,0,0.00,5,35.00,35.98,100,0
STLC,98,0,0.00,0,0.00,35.92,98,0
BJUN,97,0,0.00,100,21.31,31.02,97,0
SOVB,90,0,0.00,350,22.51,25.75,90,0
IQM,75,100,49.81,0,0.00,45.88,75,0
FYLD,67,0,0.00,0,0.00,24.61,67,0
FLQM,63,0,0.00,0,0.00,38.11,63,0
VIRS,60,0,0.00,0,0.00,29.27,60,0
IEFN,59,0,0.00,2,24.50,25.30,59,0
VMOT,59,0,0.00,0,0.00,27.46,59,0
IDHD,58,3,26.96,0,0.00,25.92,58,0
SULR,54,3,33.50,0,0.00,32.46,52,2
SPMV,52,0,0.00,0,0.00,33.66,52,0
STLG,50,0,0.00,0,0.00,32.40,50,0
WIL,47,0,0.00,0,0.00,79.00,47,0
ADFI,42,0,0.00,0,0.00,9.88,42,0
BOSS,42,0,0.00,0,0.00,31.37,42,0
FEDX,42,0,0.00,0,0.00,26.82,42,0
KOCT,38,0,0.00,0,0.00,25.88,38,0
STSB,38,0,0.00,0,0.00,43.85,38,0
HEGD,36,0,0.00,0,0.00,16.88,36,0
NURE,32,0,0.00,0,0.00,27.26,32,0
ALTS,29,0,0.00,0,0.00,37.26,29,0
IVSG,28,0,0.00,0,0.00,12.37,28,0
ACSI,25,0,0.00,0,0.00,42.90,25,0
QLC,24,0,0.00,100,39.35,41.44,24,0
FLQS,20,0,0.00,0,0.00,33.75,20,0
KWT,20,0,0.00,1,25.88,28.37,20,0
PBTP,18,0,0.00,0,0.00,26.03,18,0
AESR,15,0,0.00,2,7.77,11.92,15,0
ICOW,15,0,0.00,0,0.00,28.96,15,0
RODI,15,0,0.00,0,0.00,99.06,15,0
SLT,14,0,0.00,10,19.37,36.62,14,0
AVDG,13,0,0.00,0,0.00,25.56,13,0
RESD,13,0,0.00,0,0.00,28.69,13,0
DBJA,12,400,28.00,0,0.00,25.51,12,0
EAOM,11,0,0.00,0,0.00,27.77,11,0
MIG,11,0,0.00,50,23.95,25.03,11,0
ESEB,10,0,0.00,0,0.00,21.31,10,0
LEAD,10,0,0.00,0,0.00,47.11,10,0
PSMD,10,0,0.00,0,0.00,20.70,10,0
VWID,10,0,0.00,0,0.00,27.22,10,0
DFVS,9,0,0.00,0,0.00,13.83,9,0
EGIS,9,0,0.00,0,0.00,26.96,9,0
GSEE,9,0,0.00,0,0.00,57.49,9,0
LYFE,9,0,0.00,0,0.00,26.00,9,0
MAAX,8,0,0.00,5,25.00,25.22,8,0
PWS,8,0,0.00,0,0.00,29.63,8,0
EMSH,5,0,0.00,0,0.00,73.52,5,0
ESHY,5,0,0.00,0,0.00,21.75,5,0
PAPR,5,0,0.00,0,0.00,27.17,5,0
PBDM,5,0,0.00,0,0.00,27.37,5,0
AMER,4,10,275.00,0,0.00,26.17,4,0
UAPR,4,0,0.00,0,0.00,24.85,4,0
EURZ,3,5,24.41,0,0.00,24.24,3,0
LIV,3,0,0.00,0,0.00,26.72,3,0
RVRS,3,0,0.00,0,0.00,19.19,3,0
SFIG,3,0,0.00,0,0.00,51.71,3,0
BUFD,2,0,0.00,0,0.00,19.94,2,0
DNOV,2,0,0.00,0,0.00,33.28,2,0
DOCT,1,0,0.00,0,0.00,30.80,1,0
EAOR,1,0,0.00,0,0.00,29.34,1,0
GSID,1,0,0.00,0,0.00,52.87,1,0
HCRB,1,0,0.00,0,0.00,41.72,1,0
KJUL,1,0,0.00,0,0.00,25.86,1,0
NVMZ,1,0,0.00,0,0.00,27.66,1,0
RTAI,1,0,0.00,0,0.00,26.16,1,0
STMB,1,0,0.00,0,0.00,37.67,1,0
TMDV,1,0,0.00,0,0.00,41.43,1,0
ARCM,0,0,0.00,0,0.00,0.00,0,0
AUGZ,0,0,0.00,0,0.00,0.00,0,0
AVDR,0,10,25.69,0,0.00,0.00,0,0
BAUG,0,0,0.00,0,0.00,0.00,0,0
BMAY,0,0,0.00,0,0.00,0.00,0,0
CFCV,0,0,0.00,0,0.00,0.00,0,0
DECZ,0,0,0.00,0,0.00,0.00,0,0
DEFN,0,0,0.00,0,0.00,0.00,0,0
DFVL,0,0,0.00,15,70.00,0.00,0,0
DMAY,0,0,0.00,0,0.00,0.00,0,0
DSEP,0,0,0.00,0,0.00,0.00,0,0
DSJA,0,0,0.00,0,0.00,0.00,0,0
DSOC,0,0,0.00,50,27.38,0.00,0,0
ESCR,0,0,0.00,0,0.00,0.00,0,0
EUDV,0,0,0.00,80,36.18,0.00,0,0
FFSG,0,0,0.00,0,0.00,0.00,0,0
FJUL,0,0,0.00,0,0.00,0.00,0,0
FOCT,0,0,0.00,0,0.00,0.00,0,0
FUT,0,0,0.00,0,0.00,0.00,0,0
IMLP,0,0,0.00,0,0.00,0.00,0,0
JANZ,0,0,0.00,0,0.00,0.00,0,0
JULZ,0,0,0.00,0,0.00,0.00,0,0
KAPR,0,0,0.00,0,0.00,0.00,0,0
MRGR,0,0,0.00,0,0.00,0.00,0,0
MSVX,0,0,0.00,0,0.00,0.00,0,0
NAPR,0,0,0.00,2,35.36,0.00,0,0
OCTZ,0,0,0.00,0,0.00,0.00,0,0
PBND,0,0,0.00,0,0.00,0.00,0,0
PSCX,0,0,0.00,0,0.00,0.00,0,0
RDFI,0,0,0.00,0,0.00,0.00,0,0
RODE,0,0,0.00,0,0.00,0.00,0,0
SEPZ,0,0,0.00,0,0.00,0.00,0,0
STLV,0,0,0.00,0,0.00,0.00,0,0
TAEQ,0,0,0.00,0,0.00,0.00,0,0
TBJL,0,0,0.00,0,0.00,0.00,0,0
TEGS,0,0,0.00,0,0.00,0.00,0,0
TFLT,0,0,0.00,0,0.00,0.00,0,0
TTAI,0,0,0.00,0,0.00,0.00,0,0
UJUL,0,0,0.00,0,0.00,0.00,0,0
UNOV,0,0,0.00,0,0.00,0.00,0,0
USEQ,0,0,0.00,0,0.00,0.00,0,0
YDEC,0,0,0.00,0,0.00,0.00,0,0